data://machine/cncModel		4.1.2.1 해당 장비에 탑재된 NC의 모델명을 나타내는 문자열 속성입니다.
data://machine/numberOfChannels		4.1.2.1 해당 장비에서 사용 가능한 계통(채널)의 개수를 나타내는 정수형 속성입니다.
data://machine/cncVendor		4.1.2.1 해당 장비에 탑재된 NC의 NC 메이커를 나타냅니다. 결과값이 나타내는 의미는 매뉴얼의 표를 참조하십시오.
data://machine/ncLinkState		4.1.2.1 해당 장비에 탑재된 NC와의 통신 가능 여부를 나타내는 논리형 속성입니다.
data://machine/currentAccessLevel		4.1.2.1 (SIEMENS 전용) 해당 장비에서 프로그램 또는 디렉토리 실행, 쓰기, 나열 및 읽기에 대한 사용 권한을 나타냅니다. 사용 권한의 7단계 보안 수준을 표현하며, 1단계가 가장 높은 수준, 7단계가 가장 낮은 수준입니다. 결과값이 나타내는 의미는 매뉴얼의 표를 참조하십시오.
data://machine/basicLengthUnit		4.1.2.1 해당 장비에서 사용하는 길이 값들의 단위를 나타냅니다. 결과값이 나타내는 의미는 매뉴얼의 표를 참조하십시오.
data://machine/machinePowerOnTime		4.1.2.1 해당 장비의 전원이 켜진 시간을 나타내는 실수형 속성입니다. (단위 : 분)
data://machine/currentCncTime		4.1.2.1 해당 장비에 설정되어 있는 현재시각을 나타내는 문자열 속성입니다. (형식 : yyyy-MM-ddTHH:mm:ss)
data://machine/machineType		4.1.2.1 해당 장비의 타입을 나타내는 정수형 속성입니다. 결과값이 나타내는 의미는 매뉴얼의 표를 참조하십시오.
data://machine/ncMemory/totalCapacity		4.1.2.2 NC 메모리의 전체 용량을 나타내는 실수형 속성입니다.
data://machine/ncMemory/usedCapacity		4.1.2.2 NC 메모리의 사용 중인 용량을 나타내는 실수형 속성입니다.
data://machine/ncMemory/freeCapacity		4.1.2.2 NC 메모리의 잔여 용량을 나타내는 실수형 속성입니다.
data://machine/ncMemory/rootPath		4.1.2.2 NC 메모리의 기본 경로(최상위 경로)를 나타내는 문자열 속성입니다.
data://machine/channel/channelEnabled	channel=1	4.1.2.3 해당 계통(채널)의 사용 가능 여부를 나타내는 논리형 속성입니다.
data://machine/channel/toolAreaNumber	channel=1	4.1.2.3 해당 계통(채널)에서 사용 가능한 공구 영역의 식별 번호를 나타내는 정수형 속성입니다. 단계통 장비의 경우 디폴트로 1이 세팅될 수 있습니다. FANUC에서는 공구 영역과 계통이 동일하기 때문에 channel과 toolArea가 같은 개념으로 사용됩니다. SIEMENS의 공구 영역의 개수는 계통 수와 동등하며, 공구 영역과 계통 간 1:다 관계가 성립합니다. 하나의 공구 영역은 여러 개의 계통에 의해 참조될 수 있지만, 하나의 계통이 여러 개의 공구 영역을 참조하는 것은 불가능합니다.
data://machine/channel/numberOfAxes	channel=1	4.1.2.3 해당 계통에서 사용 가능한 축의 개수를 나타내는 정수형 속성입니다.
data://machine/channel/numberOfSpindles	channel=1	4.1.2.3 해당 계통에서 사용 가능한 스핀들의 개수를 나타내는 정수형 속성입니다.
data://machine/channel/alarmStatus	channel=1	4.1.2.3 해당 계통에서 발생한 알람의 상태 정보를 나타냅니다. 결과값이 나타내는 의미는 매뉴얼의 표를 참조하십시오.
data://machine/channel/numberOfAlarms	channel=1	4.1.2.3 해당 계통에서 발생한 알람의 개수를 나타내는 정수형 속성입니다.
data://machine/channel/operateMode	channel=1	4.1.2.3 공작기계의 운전 모드를 나타냅니다. 결과값이 나타내는 의미는 매뉴얼의 표를 참조하십시오.
data://machine/channel/numberOfWorkOffsets	channel=1	4.1.2.3 공작기계의 작업물 좌표계 개수를 나타내는 정수형 속성입니다.
data://machine/channel/ncState	channel=1	4.1.2.3 CNC의 작동 상태를 나타냅니다. 결과값이 나타내는 의미는 매뉴얼의 표를 참조하십시오.
data://machine/channel/motionStatus	channel=1	4.1.2.3 장비의 현재 Motion, Dwell 상태 여부를 나타내는 정수형 속성입니다. 결과값이 나타내는 의미는 매뉴얼의 표를 참조하십시오.
data://machine/channel/emergencyStatus	channel=1	4.1.2.3 장비가 현재 emergency상태인지 여부를 나타내는 정수형 속성입니다. 결과값이 나타내는 의미는 매뉴얼의 표를 참조하십시오.
data://machine/channel/axis/machinePosition	channel=1&axis=1	4.1.2.4 해당 축의 머신 좌표계를 기준으로 한 좌표값을 정의하는 실수형 속성입니다.
data://machine/channel/axis/workPosition	channel=1&axis=1	4.1.2.4 해당 축의 워크 좌표계를 기준으로 한 좌표값을 정의하는 실수형 속성입니다.
data://machine/channel/axis/distanceToGo	channel=1&axis=1	4.1.2.4 NC 프로그램에서 지령한 위치 대비 현재 남은 이동거리에 대한 해당 축의 좌표값을 정의하는 실수형 속성입니다.
data://machine/channel/axis/relativePosition	channel=1&axis=1	4.1.2.4 해당 축의 상대 좌표계를 기준으로 한 좌표값을 정의하는 실수형 속성 입니다.
data://machine/channel/axis/axisName	channel=1&axis=1	4.1.2.4 해당 축에 대한 절대좌표 축 이름을 나타내는 문자열 속성입니다.
data://machine/channel/axis/relativeAxisName	channel=1&axis=1	4.1.2.4 (FANUC 전용) 해당 축에 대한 상대좌표 축 이름을 나타내는 문자열 속성입니다.
data://machine/channel/axis/axisLoad	channel=1&axis=1	4.1.2.4 해당 축에 걸리는 부하를 나타내는 실수형 속성입니다.
data://machine/channel/axis/axisFeed	channel=1&axis=1	4.1.2.4 해당 축에 대한 이송 속도를 나타내는 실수형 속성입니다.
data://machine/channel/axis/axisLimitPlus	channel=1&axis=1	4.1.2.4 해당 축에서 “+” 방향으로 움직일 수 있는 최대값을 나타내는 실수형 속성입니다.
data://machine/channel/axis/axisLimitMinus	channel=1&axis=1	4.1.2.4 해당 축에서 “-” 방향으로 움직일 수 있는 최대값을 나타내는 실수형 속성입니다.
data://machine/channel/axis/workAreaLimitPlus	channel=1&axis=1	4.1.2.4 충돌방지를 위해 작업 금지영역 설정 시 해당 축에서 “+” 방향으로 움직일 수 있는 최대값을 나타내는 실수형 속성입니다.
data://machine/channel/axis/workAreaLimitMinus	channel=1&axis=1	4.1.2.4 충돌방지를 위해 작업 금지영역 설정 시 해당 축에서 “-” 방향으로 움직일 수 있는 최대값을 나타내는 실수형 속성입니다.
data://machine/channel/axis/workAreaLimitPlusEnabled	channel=1&axis=1	4.1.2.4 workAreaLimitPlus 속성의 활성화 여부를 나타내는 논리형 속성입니다.
data://machine/channel/axis/workAreaLimitMinusEnabled	channel=1&axis=1	4.1.2.4 workAreaLimitMinus 속성의 활성화 여부를 나타내는 논리형 속성입니다.
data://machine/channel/axis/interlockEnabled	channel=1&axis=1	4.1.2.4 해당 축의 인터락 여부를 나타내는 논리형 속성입니다.
data://machine/channel/axis/constantSurfaceSpeedControlEnabled	channel=1&axis=1	4.1.2.4 해당 축의 주속제어 여부를 나타내는 논리형 속성입니다.
data://machine/channel/axis/axisEnabled	channel=1&axis=1	4.1.2.4 해당 축의 사용 가능 여부를 나타내는 논리형 속성입니다.
data://machine/channel/axis/axisCurrent	channel=1&axis=1	4.1.2.4 해당 축의 전류 정보를 나타내는 실수형 속성입니다.
data://machine/channel/axis/machineOrigin	channel=1&axis=1	4.1.2.4 해당 축의 초기 기계 원점에 대한 좌표값을 나타내는 실수형 속성입니다.
data://machine/channel/axis/axisTemperature	channel=1&axis=1	4.1.2.4 해당 축의 온도 정보를 나타내는 실수형 속성입니다.
data://machine/channel/axis/axisPower/actualPowerConsumption	channel=1&axis=1	4.1.2.5 해당 축에 대한 실소비 전력의 적산값을 나타내는 실수형 속성입니다. 실소비 전력은 소비전력에서 회생전력을 뺀 값입니다. (실소비 전력= 소비 전력 – 회생 전력)
data://machine/channel/axis/axisPower/powerConsumption	channel=1&axis=1	4.1.2.5 해당 축에 대한 소비전력의 적산값을 나타내는 실수형 속성입니다.
data://machine/channel/axis/axisPower/regeneratedPower	channel=1&axis=1	4.1.2.5 해당 축에 대한 회생전력의 적산값을 나타내는 실수형 속성입니다.
data://machine/channel/spindle/spindleLoad	channel=1&spindle=1	4.1.2.6 해당 스핀들에 걸리는 부하를 나타내는 실수형 속성입니다.
data://machine/channel/spindle/spindleOverride	channel=1&spindle=1	4.1.2.6 해당 스핀들의 회전 속도에 오버라이드된 비율을 나타내는 실수형 속성입니다.
data://machine/channel/spindle/spindleLimit	channel=1&spindle=1	4.1.2.6 해당 스핀들에 대한 최대 회전 속도의 한계 값을 나타내는 실수형 속성입니다.
data://machine/channel/spindle/spindleEnabled	channel=1&spindle=1	4.1.2.6 해당 스핀들의 사용 가능 여부를 나타내는 논리형 속성입니다.
data://machine/channel/spindle/spindleCurrent	channel=1&spindle=1	4.1.2.6 해당 스핀들의 전류 정보를 나타내는 실수형 속성입니다.
data://machine/channel/spindle/spindleTemperature	channel=1&spindle=1	4.1.2.6 해당 스핀들의 온도 정보를 나타내는 실수형 속성입니다.
data://machine/channel/spindle/rpm/commandedSpeed	channel=1&spindle=1	4.1.2.7 NC 프로그램이나 MDI를 통해 지령된 스핀들 회전속도 값을 나타내는 실수형 속성입니다.
data://machine/channel/spindle/rpm/actualSpeed	channel=1&spindle=1	4.1.2.7 지령된 스핀들 회전속도 값에 대해서 실제로 측정된 스핀들 회전속도 값을 나타내는 실수형 속성입니다.
data://machine/channel/spindle/rpm/speedUnit	channel=1&spindle=1	4.1.2.7 지령된 스핀들 회전속도 및 측정된 스핀들 회전속도 값의 단위 정보를 나타냅니다. 결과값이 나타내는 의미는 매뉴얼의 표를 참조하십시오.
data://machine/channel/spindle/spindlePower/actualPowerConsumption	channel=1&spindle=1	4.1.2.8 해당 스핀들에 대한 실소비 전력의 적산값을 나타내는 실수형 속성입니다. 실소비 전력은 소비전력에서 회생전력을 뺀 값입니다. (실소비 전력= 소비 전력 – 회생 전력)
data://machine/channel/spindle/spindlePower/powerConsumption	channel=1&spindle=1	4.1.2.8 해당 스핀들에 대한 소비전력의 적산값을 나타내는 실수형 속성입니다.
data://machine/channel/spindle/spindlePower/regeneratedPower	channel=1&spindle=1	4.1.2.8 해당 스핀들에 대한 회생전력의 적산값을 나타내는 실수형 속성입니다.
data://machine/channel/feed/feedOverride	channel=1	4.1.2.9 이송 속도에 오버라이드된 비율을 나타내는 실수형 속성입니다.
data://machine/channel/feed/rapidOverride	channel=1	4.1.2.9 급속 이송 속도에 오버라이드된 비율을 나타내는 실수형 속성입니다.
data://machine/channel/feed/feedRate/commandedSpeed	channel=1	4.1.2.10 NC 프로그램이나 MDI를 통해 지령된 이송속도 값을 나타내는 실수형 속성입니다.
data://machine/channel/feed/feedRate/actualSpeed	channel=1	4.1.2.10 지령된 이송속도 값에 대해서 실제로 측정된 이송속도 값을 나타내는 실수형 속성입니다.
data://machine/channel/feed/feedRate/speedUnit	channel=1	4.1.2.10 지령된 이송속도 및 측정된 이송속도 값의 단위 정보를 나타내는 데이터입니다. 결과값이 나타내는 의미는 매뉴얼의 표를 참조하십시오.
data://machine/channel/workStatus/workCounter/currentWorkCounter	channel=1&workStatus=1	4.1.2.12 현재까지 가공된 아이템의 수량을 나타내는 정수형 속성입니다.
data://machine/channel/workStatus/workCounter/targetWorkCounter	channel=1&workStatus=1	4.1.2.12 가공하고자 하는 아이템의 목표 수량을 나타내는 정수형 속성입니다.
data://machine/channel/workStatus/workCounter/totalWorkCounter	channel=1&workStatus=1	4.1.2.12 총 가공 수량을 나타내는 정수형 속성입니다.
data://machine/channel/workStatus/machiningTime/processingMachiningTime	channel=1&workStatus=1	4.1.2.13 현재 가공이 진행된 시간을 나타내는 실수형 속성입니다. (단위 : 초)
data://machine/channel/workStatus/machiningTime/estimatedMachiningTime	channel=1&workStatus=1	4.1.2.13 (SIEMENS 전용) 현재 진행 중인 가공이 완료되기까지 걸릴 것으로 예측되는 시간을 나타내는 실수형 속성입니다. (단위 : 초)
data://machine/channel/workStatus/machiningTime/machineOperationTime	channel=1&workStatus=1	4.1.2.13 자동 운전 모드에서 해당 장비의 운전시간을 나타내는 실수형 속성입니다. (단위 : 초)
data://machine/channel/workStatus/machiningTime/actualCuttingTime	channel=1&workStatus=1	4.1.2.13 해당 장비의 절삭시간을 나타내는 실수형 속성입니다. (단위 : 초)
data://machine/channel/currentProgram/sequenceNumber	channel=1	4.1.2.14 실행 중인 NC 프로그램의 시퀀스 번호를 나타내는 정수형 속성입니다.
data://machine/channel/currentProgram/currentBlockCounter	channel=1	4.1.2.14 실행 중인 NC 프로그램의 블록 카운터를 나타내는 정수형 속성입니다.
data://machine/channel/currentProgram/lastBlock	channel=1	4.1.2.14 실행 중인 NC 프로그램의 이전 블록 정보를 나타내는 문자열 속성입니다.
data://machine/channel/currentProgram/currentBlock	channel=1	4.1.2.14 실행 중인 NC 프로그램의 현재 블록 정보를 나타내는 문자열 속성입니다.
data://machine/channel/currentProgram/nextBlock	channel=1	4.1.2.14 실행 중인 NC 프로그램의 다음 블록 정보를 나타내는 문자열 속성입니다.
data://machine/channel/currentProgram/activePartProgram	channel=1	4.1.2.14 실행 중인 NC 프로그램의 블록 정보를 최대 200자까지 나타내는 문자열 속성입니다.
data://machine/channel/currentProgram/programMode	channel=1	4.1.2.14 실행 중인 NC 프로그램의 실행 모드를 나타냅니다. 결과값이 나타내는 의미는 매뉴얼의 표를 참조하십시오.
data://machine/channel/currentProgram/currentWorkOffsetIndex	channel=1	4.1.2.14 실행 중인 NC 프로그램에서 사용하고 있는 공작물 좌표계의 G 코드를 나타내는 정수형 속성입니다. 결과값이 나타내는 의미는 매뉴얼의 표를 참조하십시오.
data://machine/channel/currentProgram/currentWorkOffsetCode	channel=1	4.1.2.14 실행 중인 NC 프로그램에서 사용하고 있는 공작물 좌표계의 G 코드를 나타내는 문자열 속성입니다. currentWorkOffsetIndex에 해당하는 G 코드 문자열입니다.
data://machine/channel/currentProgram/currentDepthLevel	channel=1	4.1.2.14 (SIEMENS 전용) 실행 중인 NC 프로그램의 프로그램 레벨을 나타냅니다. 결과값이 나타내는 의미는 매뉴얼의 표를 참조하십시오.
data://machine/channel/currentProgram/modal/modalIndex	channel=1&modalIndex=1	4.1.2.15 각 NC 의 그룹 번호에 따라 G 코드 인덱스를 나타내는 정수형 속성입니다. 결과값이 나타내는 의미는 매뉴얼의 표를 참조하십시오.
data://machine/channel/currentProgram/modal/modalCode	channel=1&modalCode=1	4.1.2.15 각 NC 의 그룹 번호에 따라 G 코드 데이터를 나타내는 문자열 속성입니다. modalIndex에 해당하는 G코드 문자열입니다.
data://machine/channel/currentProgram/overallBlock/blockCounter	channel=1&overallBlock=1	4.1.2.16 (SIEMENS 전용) 프로그램 레벨에 따라 실행 중인 블록 카운터를 나타내는 정수형 속성입니다.
data://machine/channel/currentProgram/overallBlock/programName	channel=1&overallBlock=1	4.1.2.16 (SIEMENS 전용) 프로그램 레벨에 따라 실행 중인 NC 프로그램의 이름을 나타내는 문자열 속성입니다.
data://machine/channel/currentProgram/interruptBlock/depthLevel	channel=1&interruptBlock=1	4.1.2.17 (SIEMENS 전용) 중단점의 블록이 포함된 NC 프로그램의 프로그램 레벨을 나타내는 정수형 속성입니다.
data://machine/channel/currentProgram/interruptBlock/blockCounter	channel=1&interruptBlock=1	4.1.2.17 (SIEMENS 전용) 프로그램 레벨에 따라 중단점의 블록에 대한 블록 카운터를 나타내는 정수형 속성입니다.
data://machine/channel/currentProgram/interruptBlock/programName	channel=1&interruptBlock=1	4.1.2.17 (SIEMENS 전용) 프로그램 레벨에 따라 중단점의 블럭이 포함된 NC 프로그램의 이름을 나타내는 문자열 속성입니다.
data://machine/channel/currentProgram/interruptBlock/blockData	channel=1&interruptBlock=1	4.1.2.17 (SIEMENS 전용) 프로그램 레벨에 따라 중단점의 블럭 데이터를 나타내는 문자열 속성입니다.
data://machine/channel/currentProgram/interruptBlock/searchType	channel=1&interruptBlock=1	4.1.2.17 (SIEMENS 전용) 프로그램 레벨에 따라 중단점의 검색 유형을 나타냅니다. 결과값이 나타내는 의미는 매뉴얼의 표를 참조하십시오.
data://machine/channel/currentprogram/interruptblock/mainProgramName	channel=1&interruptBlock=1	4.1.2.17 (SIEMENS 전용) 프로그램 레벨에 따라 중단점에 대한 메인 프로그램의 이름을 나타내는 문자열 속성입니다.
data://machine/channel/currentProgram/currentTotalWorkOffset/workOffsetIndex	channel=1	4.1.2.18 (SIEMENS 전용) 실행 중인 NC 프로그램에서 사용하고 있는 공작물 좌표계의 G 코드를 나타냅니다. 결과값이 나타내는 의미는 매뉴얼의 표를 참조하십시오.
data://machine/channel/currentProgram/currentTotalWorkOffset/workOffsetCode	channel=1	4.1.2.18 (SIEMENS 전용) 실행 중인 NC 프로그램에서 사용하고 있는 공작물 좌표계의 G 코드를 나타내는 문자열 속성입니다.
data://machine/channel/currentProgram/currentTotalWorkOffset/workOffsetValue	channel=1&workOffsetValue=1	4.1.2.18 (SIEMENS 전용) 실행 중인 NC 프로그램에서 사용하고 있는 공작물 좌표계의 G 코드에 대한 축별 총 오프셋량의 리스트를 나타내는 실수형 속성입니다. "Filter" 로 workOffsetValue 을 사용하여 리스트 내 개체를 식별합니다.
data://machine/channel/currentProgram/currentTotalWorkOffset/workOffsetRotation	channel=1&workOffsetRotation=1	4.1.2.18 (SIEMENS 전용) 실행 중인 NC 프로그램에서 사용하고 있는 공작물 좌표계의 G 코드에 대한 축별 총 오프셋 회전량의 리스트를 나타내는 실수형 속성입니다. "Filter" 로 workOffsetRotation 을 사용하여 리스트 내 개체를 식별합니다.
data://machine/channel/currentProgram/currentTotalWorkOffset/workOffsetScalingFactor	channel=1&workOffsetScalingFactor=1	4.1.2.18 (SIEMENS 전용) 실행 중인 NC 프로그램에서 사용하고 있는 공작물 좌표계의 G 코드에 대한 축별 총 오프셋 확장량의 리스트를 나타내는 실수형 속성입니다. "Filter" 로 workOffsetScalingFactor 을 사용하여 리스트 내 개체를 식별합니다.
data://machine/channel/currentProgram/currentTotalWorkOffset/workOffsetMirroringEnabled	channel=1&workOffsetMirroringEnabled=1	4.1.2.18 (SIEMENS 전용) 실행 중인 NC 프로그램에서 사용하고 있는 공작물 좌표계의 G 코드에 대한 축별 총 오프셋 미러링 여부의 리스트를 나타내는 논리형 속성입니다. "Filter" 로 workOffsetMirroringEnabled 을 사용하여 리스트 내 개체를 식별합니다.
data://machine/channel/currentProgram/currentFile/programName	channel=1	4.1.2.19 실행 중인 NC 프로그램의 식별자로서, NC 프로그램의 파일명을 나타내는 문자열 속성입니다.
data://machine/channel/currentProgram/currentFile/programPath	channel=1	4.1.2.19 실행 중인 NC 프로그램이 저장되어 있는 디렉토리 혹은 폴더, 드라이브의 경로를 나타내는 문자열 속성입니다.
data://machine/channel/currentProgram/currentFile/programSize	channel=1	4.1.2.19 실행 중인 NC 프로그램의 파일 크기를 나타내는 실수형 속성입니다.
data://machine/channel/currentProgram/currentFile/programDate	channel=1	4.1.2.19 실행 중인 NC 프로그램의 생성 날짜에 대한 연, 월, 일, 시, 분, 초 정보를 나타내는 문자열 속성입니다.
data://machine/channel/currentProgram/currentFile/programNameWithPath	channel=1	4.1.2.19 실행 중인 NC 프로그램의 파일명을 디렉토리 혹은 폴더, 드라이브 경로와 함께 표현한 문자열 속성입니다.
data://machine/channel/currentProgram/mainFile/programName	channel=1	4.1.2.20 선택 중인 NC 프로그램의 식별자로서, NC 프로그램의 파일명을 나타내는 문자열 속성입니다.
data://machine/channel/currentProgram/mainFile/programPath	channel=1	4.1.2.20 선택 중인 NC 프로그램이 저장되어 있는 디렉토리 혹은 폴더, 드라이브의 경로를 나타내는 문자열 속성입니다.
data://machine/channel/currentProgram/mainFile/programSize	channel=1	4.1.2.20 선택 중인 NC 프로그램의 파일 크기를 나타내는 실수형 속성입니다.
data://machine/channel/currentProgram/mainFile/programDate	channel=1	4.1.2.20 선택 중인 NC 프로그램의 생성 날짜에 대한 연, 월, 일, 시, 분, 초 정보를 나타내는 문자열 속성입니다.
data://machine/channel/currentProgram/mainFile/programNameWithPath	channel=1	4.1.2.20 선택 중인 NC 프로그램의 파일명을 디렉토리 혹은 폴더, 드라이브 경로와 함께 표현한 문자열 속성입니다.
data://machine/channel/currentProgram/controlOption/singleBlock	channel=1	4.1.2.21 NC 프로그램 실행 시, 한 블럭의 실행이 종료될 때마다 자동운전이 정지되도록 하는 기능에 대한 활성화 여부를 나타내는 논리형 속성입니다.
data://machine/channel/currentProgram/controlOption/dryRun	channel=1	4.1.2.21 NC 프로그램 실행 시, 수동으로 지정한 이송속도로 움직이도록 하는 기능에 대한 활성화 여부를 나타내는 논리형 속성입니다.
data://machine/channel/currentProgram/controlOption/optionalStop	channel=1	4.1.2.21 NC 프로그램 실행 시, M01 명령을 이용하여 선택적으로 정지할 수 있도록 하는 기능에 대한 활성화 여부를 나타내는 논리형 속성입니다.
data://machine/channel/currentProgram/controlOption/blockSkip	channel=1&blockSkip=1	4.1.2.21 NC 프로그램 실행 시, ‘/’로 시작하는 블록을 실행하지 않고 건너뛸 수 있도록 하는 기능에 대한 활성화 여부의 리스트를 나타내는 논리형 속성입니다. "Filter" 로 blockSkip 을 사용하여 리스트 내 개체를 식별합니다.
data://machine/channel/currentProgram/controlOption/machineLock	channel=1	4.1.2.21 축을 이송하지 않고 NC 프로그램을 실행시키는 기능에 대한 활성화 여부를 나타내는 논리형 속성입니다.
data://machine/channel/workOffset/workOffsetValue	channel=1&workOffset=1&workOffsetValue=1	4.1.2.22 해당 계통에서 G 코드 인덱스에 대한 축별 오프셋량의 리스트를 나타내는 실수형 속성입니다. "Filter" 로 workOffsetValue 을 사용하여 리스트 내 개체를 식별합니다.
data://machine/channel/workOffset/workOffsetRotation	channel=1&workOffset=1&workOffsetRotation=1	4.1.2.22 (SIEMENS 전용) 해당 계통에서 G 코드 인덱스에 대한 축별 오프셋 회전량의 리스트를 나타내는 실수형 속성입니다. "Filter" 로 workOffsetRotation 을 사용하여 리스트 내 개체를 식별합니다.
data://machine/channel/workOffset/workOffsetScalingFactor	channel=1&workOffset=1&workOffsetScalingFactor=1	4.1.2.22 (SIEMENS 전용) 해당 계통에서 G 코드 인덱스에 대한 축별 오프셋 확장량의 리스트를 나타내는 실수형 속성입니다. "Filter" 로 workOffsetScalingFactor 을 사용하여 리스트 내 개체를 식별합니다.
data://machine/channel/workOffset/workOffsetMirroringEnabled	channel=1&workOffset=1&workOffsetMirroringEnabled=1	4.1.2.22 (SIEMENS 전용) 해당 계통에서 G 코드 인덱스에 대한 축별 오프셋량 미러링 여부의 리스트를 나타내는 논리형 속성입니다. "Filter" 로 workOffsetMirroringEnabled 을 사용하여 리스트 내 개체를 식별합니다.
data://machine/channel/workOffset/workOffsetFine	channel=1&workOffset=1&workOffsetFine=1	4.1.2.22 (SIEMENS 전용) 해당 계통에서 G 코드 인덱스에 대한 축별 오프셋 Fine의 리스트를 나타내는 실수형 속성입니다. "Filter" 로 workOffsetFine 을 사용하여 리스트 내 개체를 식별합니다.
data://machine/channel/alarm	channel=1	4.1.2.23 해당 계통에서 발생한 모든 알람에 대한 Text, Category, Number, raisedTimeStamp를 리스트로 나타내는 문자열(JSON 형태) 속성입니다.
data://machine/channel/alarm/alarmText	channel=1&alarm=1	4.1.2.23 해당 계통에서 발생한 알람에 대한 상세한 설명을 나타내는 문자열 속성입니다.
data://machine/channel/alarm/alarmCategory	channel=1&alarm=1	4.1.2.23 해당 계통에서 발생한 알람의 유형에 대한 정보를 표현하는 문자열 속성입니다.
data://machine/channel/alarm/alarmNumber	channel=1&alarm=1	4.1.2.23 해당 계통에서 발생한 알람의 종류에 대한 번호를 나타내는 문자열 속성입니다.
data://machine/channel/alarm/raisedTimeStamp	channel=1&alarm=1	4.1.2.23 해당 계통에서 발생한 알람의 발생 시간 정보를 나타내는 문자열 속성입니다.
data://machine/channel/variable/userVariable	channel=1&variable=500	4.1.2.24 해당 계통(채널)에서 사용하는 사용자 변수입니다.
data://machine/toolArea/toolAreaEnabled	toolArea=1	4.1.2.25 해당 공구 영역의 사용 가능 여부를 나타내는 논리형 속성입니다.
data://machine/toolArea/numberOfMagazines	toolArea=1	4.1.2.25 해당 공구 영역에서 사용 가능한 매거진의 개수를 나타내는 정수형 속성입니다.
data://machine/toolArea/numberOfRegisteredTools	toolArea=1	4.1.2.25 해당 공구 영역에 등록된 공구의 개수를 나타내는 정수형 속성입니다.
data://machine/toolArea/numberOfLoadedTools	toolArea=1	4.1.2.25 해당 공구 영역에 등록된 공구 중 매거진에 탑재된 공구의 개수를 나타내는 정수형 속성입니다.
data://machine/toolArea/numberOfToolGroups	toolArea=1	4.1.2.25 해당 공구 영역에 등록된 공구 그룹의 개수를 나타내는 정수형 속성입니다.
data://machine/toolArea/numberOfToolOffsets	toolArea=1	4.1.2.25 해당 공구 영역에 등록된 공구 오프셋의 개수를 나타내는 정수형 속성입니다.
data://machine/toolArea/magazine/magazineEnabled	toolArea=1&magazine=1	4.1.2.26 해당 매거진의 사용 가능 여부를 나타내는 논리형 속성입니다.
data://machine/toolArea/magazine/magazineName	toolArea=1&magazine=1	4.1.2.26 (SIEMENS 전용) 해당 매거진의 이름을 나타내는 고유의 문자열로 표현됩니다.
data://machine/toolArea/magazine/numberOfRealLocations	toolArea=1&magazine=1	4.1.2.26 해당 매거진에 공구 탑재가 가능한 물리적 위치의 개수를 나타내는 정수형 속성입니다.
data://machine/toolArea/magazine/magazinePhysicalNumber	toolArea=1&magazine=1	4.1.2.26 해당 매거진에 할당된 물리적 번호를 나타내는 정수형 속성입니다.
data://machine/toolArea/magazine/numberOfLoadedTools	toolArea=1&magazine=1	4.1.2.26 해당 매거진에 탑재된 공구의 개수를 나타내는 정수형 속성입니다.
data://machine/channel/activeTool/locationNumber	channel=1	4.1.2.27 해당 공구가 매거진 내 탑재된 위치를 나타내는 정수형 속성입니다.
data://machine/toolArea/tools/locationNumber	toolArea=1&tools=1	4.1.2.27 해당 공구가 매거진 내 탑재된 위치를 나타내는 정수형 속성입니다.
data://machine/toolArea/registerTools/locationNumber	toolArea=1&registerTools=1	4.1.2.27 해당 공구가 매거진 내 탑재된 위치를 나타내는 정수형 속성입니다.
data://machine/channel/activetool/toolName	channel=1	4.1.2.27 해당 공구의 이름을 나타내는 문자열 속성입니다.
data://machine/toolArea/tools/toolName	toolArea=1&tools=1	4.1.2.27 해당 공구의 이름을 나타내는 문자열 속성입니다.
data://machine/toolArea/registerTools/toolName	toolArea=1&registerTools=1	4.1.2.27 해당 공구의 이름을 나타내는 문자열 속성입니다.
data://machine/channel/activetool/toolNumber	channel=1	4.1.2.27 해당 공구의 식별자로서, 공구 번호를 나타내는 정수형 속성입니다. activeTool의 공구 번호를 나타내며, tools, registerTools에서는 인덱스 속성이므로 데이터의 읽고 쓰기가 불가능합니다.
data://machine/channel/activetool/numberOfEdges	channel=1	4.1.2.27 해당 공구에 대한 공구 날의 총 개수를 나타내는 정수형 속성으로, 기본 값으로 1이 설정됩니다.
data://machine/toolArea/tools/numberOfEdges	toolArea=1&tools=1	4.1.2.27 해당 공구에 대한 공구 날의 총 개수를 나타내는 정수형 속성으로, 기본 값으로 1이 설정됩니다.
data://machine/toolArea/registerTools/numberOfEdges	toolArea=1&registerTools=1	4.1.2.27 해당 공구에 대한 공구 날의 총 개수를 나타내는 정수형 속성으로, 기본 값으로 1이 설정됩니다.
data://machine/channel/activetool/toolEnabled	channel=1	4.1.2.27 해당 공구의 공구 영역 등록 및 매거진 탑재 여부를 나타냅니다. 결과값이 나타내는 의미는 매뉴얼의 표를 참조하십시오.
data://machine/toolArea/tools/toolEnabled	toolArea=1&tools=1&toolGroupNumber=1	4.1.2.27 해당 공구의 공구 영역 등록 및 매거진 탑재 여부를 나타냅니다. 결과값이 나타내는 의미는 매뉴얼의 표를 참조하십시오.
data://machine/toolArea/registerTools/toolEnabled	toolArea=1&registerTools=1&toolGroupNumber=1	4.1.2.27 해당 공구의 공구 영역 등록 및 매거진 탑재 여부를 나타냅니다. 결과값이 나타내는 의미는 매뉴얼의 표를 참조하십시오.
data://machine/channel/activetool/magazineNumber	channel=1	4.1.2.27 해당 공구가 탑재된 매거진의 번호를 나타내는 정수형 속성입니다.
data://machine/toolArea/tools/magazineNumber	toolArea=1&tools=1	4.1.2.27 해당 공구가 탑재된 매거진의 번호를 나타내는 정수형 속성입니다.
data://machine/toolArea/registerTools/magazineNumber	toolArea=1&registerTools=1	4.1.2.27 해당 공구가 탑재된 매거진의 번호를 나타내는 정수형 속성입니다.
data://machine/channel/activetool/sisterToolNumber	channel=1	4.1.2.27 해당 공구에 할당된 대체 공구 번호를 나타내는 정수형 속성입니다. SIEMENS에서는 현재 사용 중인 공구의 수명이 다하였을 때 대체하여 사용할 공구들에게 오름차순으로 해당 번호를 할당합니다.
data://machine/toolArea/tools/sisterToolNumber	toolArea=1&tools=1	4.1.2.27 해당 공구에 할당된 대체 공구 번호를 나타내는 정수형 속성입니다. SIEMENS에서는 현재 사용 중인 공구의 수명이 다하였을 때 대체하여 사용할 공구들에게 오름차순으로 해당 번호를 할당합니다.
data://machine/toolArea/registerTools/sisterToolNumber	toolArea=1&registerTools=1	4.1.2.27 해당 공구에 할당된 대체 공구 번호를 나타내는 정수형 속성입니다. SIEMENS에서는 현재 사용 중인 공구의 수명이 다하였을 때 대체하여 사용할 공구들에게 오름차순으로 해당 번호를 할당합니다.
data://machine/channel/activetool/toolLifeUnit	channel=1	4.1.2.27 해당 공구의 공구 수명을 측정하는 단위 기준을 나타냅니다. 결과값이 나타내는 의미는 매뉴얼의 표를 참조하십시오.
data://machine/toolArea/tools/toolLifeUnit	toolArea=1&tools=1&toolLifeUnit=1	4.1.2.27 해당 공구의 공구 수명을 측정하는 단위 기준을 나타냅니다. 결과값이 나타내는 의미는 매뉴얼의 표를 참조하십시오.
data://machine/toolArea/registerTools/toolLifeUnit	toolArea=1&registerTools=1&toolLifeUnit=1	4.1.2.27 해당 공구의 공구 수명을 측정하는 단위 기준을 나타냅니다. 결과값이 나타내는 의미는 매뉴얼의 표를 참조하십시오.
data://machine/channel/activetool/toolGroupNumber	channel=1	4.1.2.27 해당 공구가 참조된 공구 그룹 번호의 리스트를 나타내는 정수형 속성입니다.
data://machine/toolArea/tools/toolGroupNumber	toolArea=1&tools=1	4.1.2.27 해당 공구가 참조된 공구 그룹 번호의 리스트를 나타내는 정수형 속성입니다.
data://machine/toolArea/registerTools/toolGroupNumber	toolArea=1&registerTools=1	4.1.2.27 해당 공구가 참조된 공구 그룹 번호의 리스트를 나타내는 정수형 속성입니다.
data://machine/channel/activetool/toolUseOrderNumber	channel=1	4.1.2.27 (FANUC 전용) 해당 공구가 참조된 공구 그룹 내에서의 공구 사용 순서를 나타내는 정수형 속성입니다.
data://machine/toolArea/tools/toolUseOrderNumber	toolArea=1&tools=1&toolUseOrderNumber=1	4.1.2.27 (FANUC 전용) 해당 공구가 참조된 공구 그룹 내에서의 공구 사용 순서를 나타내는 정수형 속성입니다.
data://machine/toolArea/registerTools/toolUseOrderNumber	toolArea=1&registerTools=1&toolUseOrderNumber=1	4.1.2.27 (FANUC 전용) 해당 공구가 참조된 공구 그룹 내에서의 공구 사용 순서를 나타내는 정수형 속성입니다.
data://machine/channel/activetool/toolStatus	channel=1	4.1.2.27 해당 공구의 사용 상태를 나타냅니다. 결과값이 나타내는 의미는 매뉴얼의 표를 참조하십시오.
data://machine/toolArea/tools/toolStatus	toolArea=1&tools=1&toolStatus=1	4.1.2.27 해당 공구의 사용 상태를 나타냅니다. 결과값이 나타내는 의미는 매뉴얼의 표를 참조하십시오.
data://machine/toolArea/registerTools/toolStatus	toolArea=1&registerTools=1&toolStatus=1	4.1.2.27 해당 공구의 사용 상태를 나타냅니다. 결과값이 나타내는 의미는 매뉴얼의 표를 참조하십시오.
data://machine/channel/activetool/toolEdge/edgeNumber	channel=1	4.1.2.28 해당 공구에 대한 공구 날의 개수가 하나 이상일 때 각 날을 식별할 수 있는 공구 날 번호를 나타내는 정수형 속성으로 디폴트로 1이 설정됩니다. tools, registerTools에서는 인덱스 속성이므로 데이터의 읽고 쓰기가 불가능합니다.
data://machine/channel/activetool/toolEdge/toolType	channel=1	4.1.2.28 해당 공구의 유형을 나타냅니다. 결과값이 나타내는 의미는 매뉴얼의 표를 참조하십시오.
data://machine/toolArea/tools/toolEdge/toolType	toolArea=1&tools=1&toolEdge=1	4.1.2.28 해당 공구의 유형을 나타냅니다. 결과값이 나타내는 의미는 매뉴얼의 표를 참조하십시오.
data://machine/toolArea/registerTools/toolEdge/toolType	toolArea=1&registerTools=1&toolEdge=1	4.1.2.28 해당 공구의 유형을 나타냅니다. 결과값이 나타내는 의미는 매뉴얼의 표를 참조하십시오.
data://machine/channel/activetool/toolEdge/lengthOffsetNumber	channel=1	4.1.2.28 FANUC에서 사용되는 lengthOffsetNumber는 해당 공구에 대한 기하학적인 공구 길이와 공구 길이의 마모값에 대한 식별 번호를 나타내는 정수형 속성입니다. SIEMENS에는 해당 속성과 대응되는 데이터로 hNumber가 존재합니다. hNumber 는 SIEMENS에서 ISO 모드로 NC 프로그램을 실행시키는 경우 CNC에 탑재된 공구의 오프셋 값을 가져오기 위해 공구 길이 오프셋 값의 식별자를 나타내는 정수형 속성입니다. hNumber를 사용하기 위해서는 SIEMENS의 MD(Machine Data) 18800이 1로 설정되어야 합니다.
data://machine/toolArea/tools/toolEdge/lengthOffsetNumber	toolArea=1&tools=1&toolEdge=1&lengthOffsetNumber=1	4.1.2.28 FANUC에서 사용되는 lengthOffsetNumber는 해당 공구에 대한 기하학적인 공구 길이와 공구 길이의 마모값에 대한 식별 번호를 나타내는 정수형 속성입니다. SIEMENS에는 해당 속성과 대응되는 데이터로 hNumber가 존재합니다. hNumber 는 SIEMENS에서 ISO 모드로 NC 프로그램을 실행시키는 경우 CNC에 탑재된 공구의 오프셋 값을 가져오기 위해 공구 길이 오프셋 값의 식별자를 나타내는 정수형 속성입니다. hNumber를 사용하기 위해서는 SIEMENS의 MD(Machine Data) 18800이 1로 설정되어야 합니다.
data://machine/toolArea/registerTools/toolEdge/lengthOffsetNumber	toolArea=1&registerTools=1&toolEdge=1&lengthOffsetNumber=1	4.1.2.28 FANUC에서 사용되는 lengthOffsetNumber는 해당 공구에 대한 기하학적인 공구 길이와 공구 길이의 마모값에 대한 식별 번호를 나타내는 정수형 속성입니다. SIEMENS에는 해당 속성과 대응되는 데이터로 hNumber가 존재합니다. hNumber 는 SIEMENS에서 ISO 모드로 NC 프로그램을 실행시키는 경우 CNC에 탑재된 공구의 오프셋 값을 가져오기 위해 공구 길이 오프셋 값의 식별자를 나타내는 정수형 속성입니다. hNumber를 사용하기 위해서는 SIEMENS의 MD(Machine Data) 18800이 1로 설정되어야 합니다.
data://machine/channel/activetool/toolEdge/geoLengthOffset	channel=1	4.1.2.28 해당 공구의 길이 X를 나타내는 실수형 속성입니다.
data://machine/toolArea/tools/toolEdge/geoLengthOffset	toolArea=1&tools=1&toolEdge=1&geoLengthOffset=1	4.1.2.28 해당 공구의 길이 X를 나타내는 실수형 속성입니다.
data://machine/toolArea/registerTools/toolEdge/geoLengthOffset	toolArea=1&registerTools=1&toolEdge=1&geoLengthOffset=1	4.1.2.28 해당 공구의 길이 X를 나타내는 실수형 속성입니다.
data://machine/channel/activetool/toolEdge/wearLengthOffset	channel=1	4.1.2.28 해당 공구의 길이 X에 대한 마모값을 나타내는 실수형 속성입니다.
data://machine/toolArea/tools/toolEdge/wearLengthOffset	toolArea=1&tools=1&toolEdge=1&wearLengthOffset=1	4.1.2.28 해당 공구의 길이 X에 대한 마모값을 나타내는 실수형 속성입니다.
data://machine/toolArea/registerTools/toolEdge/wearLengthOffset	toolArea=1&registerTools=1&toolEdge=1&wearLengthOffset=1	4.1.2.28 해당 공구의 길이 X에 대한 마모값을 나타내는 실수형 속성입니다.
data://machine/channel/activetool/toolEdge/radiusOffsetNumber	channel=1	4.1.2.28 FANUC에서 사용되는 radiusOffsetNumber은 해당 공구에 대한 기하학적인 공구 반경과 공구 반경의 마모값의 식별 번호를 나타내는 정수형 속성입니다. SIEMENS에는 해당 속성과 대응되는 데이터로 hNumber가 존재합니다. hNumber는 SIEMENS에서 ISO 모드로 NC 프로그램을 실행시키는 경우 CNC에 탑재된 공구의 오프셋 값을 가져오기 위해 공구 반경 오프셋 값의 식별자를 나타내는 정수형 속성입니다. hNumber를 사용하기 위해서는 SIEMENS의 MD(Machine Data) 18800이 1로 설정되어야 합니다.
data://machine/toolArea/tools/toolEdge/radiusOffsetNumber	toolArea=1&tools=1&toolEdge=1&radiusOffsetNumber=1	4.1.2.28 FANUC에서 사용되는 radiusOffsetNumber은 해당 공구에 대한 기하학적인 공구 반경과 공구 반경의 마모값의 식별 번호를 나타내는 정수형 속성입니다. SIEMENS에는 해당 속성과 대응되는 데이터로 hNumber가 존재합니다. hNumber는 SIEMENS에서 ISO 모드로 NC 프로그램을 실행시키는 경우 CNC에 탑재된 공구의 오프셋 값을 가져오기 위해 공구 반경 오프셋 값의 식별자를 나타내는 정수형 속성입니다. hNumber를 사용하기 위해서는 SIEMENS의 MD(Machine Data) 18800이 1로 설정되어야 합니다.
data://machine/toolArea/registerTools/toolEdge/radiusOffsetNumber	toolArea=1&registerTools=1&toolEdge=1&radiusOffsetNumber=1	4.1.2.28 FANUC에서 사용되는 radiusOffsetNumber은 해당 공구에 대한 기하학적인 공구 반경과 공구 반경의 마모값의 식별 번호를 나타내는 정수형 속성입니다. SIEMENS에는 해당 속성과 대응되는 데이터로 hNumber가 존재합니다. hNumber는 SIEMENS에서 ISO 모드로 NC 프로그램을 실행시키는 경우 CNC에 탑재된 공구의 오프셋 값을 가져오기 위해 공구 반경 오프셋 값의 식별자를 나타내는 정수형 속성입니다. hNumber를 사용하기 위해서는 SIEMENS의 MD(Machine Data) 18800이 1로 설정되어야 합니다.
data://machine/channel/activetool/toolEdge/geoRadiusOffset	channel=1	4.1.2.28 해당 공구의 반경을 나타내는 실수형 속성입니다.
data://machine/toolArea/tools/toolEdge/geoRadiusOffset	toolArea=1&tools=1&toolEdge=1&geoRadiusOffset=1	4.1.2.28 해당 공구의 반경을 나타내는 실수형 속성입니다.
data://machine/toolArea/registerTools/toolEdge/geoRadiusOffset	toolArea=1&registerTools=1&toolEdge=1&geoRadiusOffset=1	4.1.2.28 해당 공구의 반경을 나타내는 실수형 속성입니다.
data://machine/channel/activetool/toolEdge/wearRadiusOffset	channel=1	4.1.2.28 해당 공구의 반경에 대한 마모값을 나타내는 실수형 속성입니다.
data://machine/toolArea/tools/toolEdge/wearRadiusOffset	toolArea=1&tools=1&toolEdge=1&wearRadiusOffset=1	4.1.2.28 해당 공구의 반경에 대한 마모값을 나타내는 실수형 속성입니다.
data://machine/toolArea/registerTools/toolEdge/wearRadiusOffset	toolArea=1&registerTools=1&toolEdge=1&wearRadiusOffset=1	4.1.2.28 해당 공구의 반경에 대한 마모값을 나타내는 실수형 속성입니다.
data://machine/channel/activetool/toolEdge/edgeEnabled	channel=1	4.1.2.28 해당 공구의 공구 날에 대한 사용 가능 여부를 나타내는 논리형 속성입니다.
data://machine/toolArea/tools/toolEdge/edgeEnabled	toolArea=1&tools=1&toolEdge=1	4.1.2.28 해당 공구의 공구 날에 대한 사용 가능 여부를 나타내는 논리형 속성입니다.
data://machine/toolArea/registerTools/toolEdge/edgeEnabled	toolArea=1&registerTools=1&toolEdge=1	4.1.2.28 해당 공구의 공구 날에 대한 사용 가능 여부를 나타내는 논리형 속성입니다.
data://machine/channel/activetool/toolEdge/geoLengthOffsetZ	channel=1	4.1.2.28 해당 공구의 길이 Z를 나타내는 실수형 속성입니다.
data://machine/toolArea/tools/toolEdge/geoLengthOffsetZ	toolArea=1&tools=1&toolEdge=1&geoLengthOffsetZ=1	4.1.2.28 해당 공구의 길이 Z를 나타내는 실수형 속성입니다.
data://machine/toolArea/registerTools/toolEdge/geoLengthOffsetZ	toolArea=1&registerTools=1&toolEdge=1&geoLengthOffsetZ=1	4.1.2.28 해당 공구의 길이 Z를 나타내는 실수형 속성입니다.
data://machine/channel/activetool/toolEdge/wearLengthOffsetZ	channel=1	4.1.2.28 해당 공구의 길이 Z에 대한 마모값을 나타내는 실수형 속성입니다.
data://machine/toolArea/tools/toolEdge/wearLengthOffsetZ	toolArea=1&tools=1&toolEdge=1&wearLengthOffsetZ=1	4.1.2.28 해당 공구의 길이 Z에 대한 마모값을 나타내는 실수형 속성입니다.
data://machine/toolArea/registerTools/toolEdge/wearLengthOffsetZ	toolArea=1&registerTools=1&toolEdge=1&wearLengthOffsetZ=1	4.1.2.28 해당 공구의 길이 Z에 대한 마모값을 나타내는 실수형 속성입니다.
data://machine/channel/activeTool/toolEdge/geoLengthOffsetY	channel=1	4.1.2.28 해당 공구의 길이 Y를 나타내는 실수형 속성입니다.
data://machine/toolArea/tools/toolEdge/geoLengthOffsetY	toolArea=1&tools=1&toolEdge=1&geoLengthOffsetY=1	4.1.2.28 해당 공구의 길이 Y를 나타내는 실수형 속성입니다.
data://machine/toolArea/registerTools/toolEdge/geoLengthOffsetY	toolArea=1&registerTools=1&toolEdge=1&geoLengthOffsetY=1	4.1.2.28 해당 공구의 길이 Y를 나타내는 실수형 속성입니다.
data://machine/channel/activeTool/toolEdge/wearLengthOffsetY	channel=1	4.1.2.28 해당 공구의 길이 Y에 대한 마모값을 나타내는 실수형 속성입니다.
data://machine/toolArea/tools/toolEdge/wearLengthOffsetY	toolArea=1&tools=1&toolEdge=1&wearLengthOffsetY=1	4.1.2.28 해당 공구의 길이 Y에 대한 마모값을 나타내는 실수형 속성입니다.
data://machine/toolArea/registerTools/toolEdge/wearLengthOffsetY	toolArea=1&registerTools=1&toolEdge=1&wearLengthOffsetY=1	4.1.2.28 해당 공구의 길이 Y에 대한 마모값을 나타내는 실수형 속성입니다.
data://machine/channel/activetool/toolEdge/geoOffsetNumber	channel=1	4.1.2.28 해당 공구의 길이 X, 길이 Z, 반경의 식별 번호를 나타내는 정수형 속성입니다.
data://machine/toolArea/tools/toolEdge/geoOffsetNumber	toolArea=1&tools=1&toolEdge=1&geoOffsetNumber=1	4.1.2.28 해당 공구의 길이 X, 길이 Z, 반경의 식별 번호를 나타내는 정수형 속성입니다.
data://machine/toolArea/registerTools/toolEdge/geoOffsetNumber	toolArea=1&registerTools=1&toolEdge=1&geoOffsetNumber=1	4.1.2.28 해당 공구의 길이 X, 길이 Z, 반경의 식별 번호를 나타내는 정수형 속성입니다.
data://machine/channel/activetool/toolEdge/wearOffsetNumber	channel=1	4.1.2.28 해당 공구의 길이 X, 길이 Z, 반경에 대한 마모값들의 식별 번호를 나타내는 정수형 속성입니다.
data://machine/toolArea/tools/toolEdge/wearOffsetNumber	toolArea=1&tools=1&toolEdge=1&wearOffsetNumber=1	4.1.2.28 해당 공구의 길이 X, 길이 Z, 반경에 대한 마모값들의 식별 번호를 나타내는 정수형 속성입니다.
data://machine/toolArea/registerTools/toolEdge/wearOffsetNumber	toolArea=1&registerTools=1&toolEdge=1&wearOffsetNumber=1	4.1.2.28 해당 공구의 길이 X, 길이 Z, 반경에 대한 마모값들의 식별 번호를 나타내는 정수형 속성입니다.
data://machine/channel/activetool/toolEdge/cuttingEdgePosition	channel=1	4.1.2.28 해당 공구의 공구 인선 방향을 나타냅니다. 결과값이 나타내는 의미는 매뉴얼의 표를 참조하십시오.
data://machine/toolArea/tools/toolEdge/cuttingEdgePosition	toolArea=1&tools=1&toolEdge=1&cuttingEdgePosition=1	4.1.2.28 해당 공구의 공구 인선 방향을 나타냅니다. 결과값이 나타내는 의미는 매뉴얼의 표를 참조하십시오.
data://machine/toolArea/registerTools/toolEdge/cuttingEdgePosition	toolArea=1&registerTools=1&toolEdge=1&cuttingEdgePosition=1	4.1.2.28 해당 공구의 공구 인선 방향을 나타냅니다. 결과값이 나타내는 의미는 매뉴얼의 표를 참조하십시오.
data://machine/channel/activetool/toolEdge/tipAngle	channel=1	4.1.2.28 해당 공구의 팁 각을 나타내는 실수형 속성입니다.
data://machine/toolArea/tools/toolEdge/tipAngle	toolArea=1&tools=1&toolEdge=1	4.1.2.28 해당 공구의 팁 각을 나타내는 실수형 속성입니다.
data://machine/toolArea/registerTools/toolEdge/tipAngle	toolArea=1&registerTools=1&toolEdge=1	4.1.2.28 해당 공구의 팁 각을 나타내는 실수형 속성입니다.
data://machine/channel/activetool/toolEdge/holderAngle	channel=1	4.1.2.28 선반 공구에만 해당하는 형상 정보로, 해당 공구의 holder angle을 나타내는 실수형 속성입니다.
data://machine/toolArea/tools/toolEdge/holderAngle	toolArea=1&tools=1&toolEdge=1	4.1.2.28 선반 공구에만 해당하는 형상 정보로, 해당 공구의 holder angle을 나타내는 실수형 속성입니다.
data://machine/toolArea/registerTools/toolEdge/holderAngle	toolArea=1&registerTools=1&toolEdge=1	4.1.2.28 선반 공구에만 해당하는 형상 정보로, 해당 공구의 holder angle을 나타내는 실수형 속성입니다.
data://machine/channel/activetool/toolEdge/insertAngle	channel=1	4.1.2.28 선반 공구에만 해당하는 형상 정보로, 해당 공구의 insert angle을 나타내는 실수형 속성입니다.
data://machine/toolArea/tools/toolEdge/insertAngle	toolArea=1&tools=1&toolEdge=1	4.1.2.28 선반 공구에만 해당하는 형상 정보로, 해당 공구의 insert angle을 나타내는 실수형 속성입니다.
data://machine/toolArea/registerTools/toolEdge/insertAngle	toolArea=1&registerTools=1&toolEdge=1	4.1.2.28 선반 공구에만 해당하는 형상 정보로, 해당 공구의 insert angle을 나타내는 실수형 속성입니다.
data://machine/channel/activetool/toolEdge/insertWidth	channel=1	4.1.2.28 (SIEMENS 전용) 해당 공구에 대한 인선의 너비를 나타내는 실수형 속성입니다.
data://machine/toolArea/tools/toolEdge/insertWidth	toolArea=1&tools=1&toolEdge=1	4.1.2.28 (SIEMENS 전용) 해당 공구에 대한 인선의 너비를 나타내는 실수형 속성입니다.
data://machine/toolArea/registerTools/toolEdge/insertWidth	toolArea=1&registerTools=1&toolEdge=1	4.1.2.28 (SIEMENS 전용) 해당 공구에 대한 인선의 너비를 나타내는 실수형 속성입니다.
data://machine/channel/activetool/toolEdge/insertLength	channel=1	4.1.2.28 (SIEMENS 전용) 선반 공구에만 해당하는 형상 정보로, 해당 공구에 대한 인선의 길이를 나타내는 실수형 속성입니다.
data://machine/toolArea/tools/toolEdge/insertLength	toolArea=1&tools=1&toolEdge=1	4.1.2.28 (SIEMENS 전용) 선반 공구에만 해당하는 형상 정보로, 해당 공구에 대한 인선의 길이를 나타내는 실수형 속성입니다.
data://machine/toolArea/registerTools/toolEdge/insertLength	toolArea=1&registerTools=1&toolEdge=1	4.1.2.28 (SIEMENS 전용) 선반 공구에만 해당하는 형상 정보로, 해당 공구에 대한 인선의 길이를 나타내는 실수형 속성입니다.
data://machine/channel/activetool/toolEdge/referenceDirectionHolderAngle	channel=1	4.1.2.28 (SIEMENS 전용) 선반 공구에만 해당하는 형상 정보로, 해당 공구에 대한 holder angle의 참조 방향을 나타내는 실수형 속성입니다.
data://machine/toolArea/tools/toolEdge/referenceDirectionHolderAngle	toolArea=1&tools=1&toolEdge=1	4.1.2.28 (SIEMENS 전용) 선반 공구에만 해당하는 형상 정보로, 해당 공구에 대한 holder angle의 참조 방향을 나타내는 실수형 속성입니다.
data://machine/toolArea/registerTools/toolEdge/referenceDirectionHolderAngle	toolArea=1&registerTools=1&toolEdge=1	4.1.2.28 (SIEMENS 전용) 선반 공구에만 해당하는 형상 정보로, 해당 공구에 대한 holder angle의 참조 방향을 나타내는 실수형 속성입니다.
data://machine/channel/activetool/toolEdge/directionOfSpindleRotation	channel=1	4.1.2.28 (SIEMENS 전용) 해당 공구의 스핀들 회전 방향을 나타냅니다. 결과값이 나타내는 의미는 매뉴얼의 표를 참조하십시오.
data://machine/toolArea/tools/toolEdge/directionOfSpindleRotation	toolArea=1&tools=1&toolEdge=1	4.1.2.28 (SIEMENS 전용) 해당 공구의 스핀들 회전 방향을 나타냅니다. 결과값이 나타내는 의미는 매뉴얼의 표를 참조하십시오.
data://machine/toolArea/registerTools/toolEdge/directionOfSpindleRotation	toolArea=1&registerTools=1&toolEdge=1	4.1.2.28 (SIEMENS 전용) 해당 공구의 스핀들 회전 방향을 나타냅니다. 결과값이 나타내는 의미는 매뉴얼의 표를 참조하십시오.
data://machine/channel/activetool/toolEdge/numberOfTeeth	channel=1	4.1.2.28 (SIEMENS 전용) 해당 공구에 대한 공구 날의 개수를 나타내는 정수형 속성입니다.
data://machine/toolArea/tools/toolEdge/numberOfTeeth	toolArea=1&tools=1&toolEdge=1	4.1.2.28 (SIEMENS 전용) 해당 공구에 대한 공구 날의 개수를 나타내는 정수형 속성입니다.
data://machine/toolArea/registerTools/toolEdge/numberOfTeeth	toolArea=1&registerTools=1&toolEdge=1	4.1.2.28 (SIEMENS 전용) 해당 공구에 대한 공구 날의 개수를 나타내는 정수형 속성입니다.
data://machine/channel/activetool/toolEdge/toolLife/maxToolLife	channel=1	4.1.2.29 해당 공구의 최대 수명을 나타내는 실수형 속성입니다.
data://machine/toolArea/tools/toolEdge/toolLife/maxToolLife	toolArea=1&tools=1&toolEdge=1&maxToolLife=1	4.1.2.29 해당 공구의 최대 수명을 나타내는 실수형 속성입니다.
data://machine/toolArea/registerTools/toolEdge/toolLife/maxToolLife	toolArea=1&registerTools=1&toolEdge=1&maxToolLife=1	4.1.2.29 해당 공구의 최대 수명을 나타내는 실수형 속성입니다.
data://machine/channel/activetool/toolEdge/toolLife/restToolLife	channel=1	4.1.2.29 해당 공구의 잔여 수명을 나타내는 실수형 속성입니다.
data://machine/toolArea/tools/toolEdge/toolLife/restToolLife	toolArea=1&tools=1&toolEdge=1&restToolLife=1	4.1.2.29 해당 공구의 잔여 수명을 나타내는 실수형 속성입니다.
data://machine/toolArea/registerTools/toolEdge/toolLife/restToolLife	toolArea=1&registerTools=1&toolEdge=1&restToolLife=1	4.1.2.29 해당 공구의 잔여 수명을 나타내는 실수형 속성입니다.
data://machine/channel/activetool/toolEdge/toolLife/toolLifeCount	channel=1	4.1.2.29 해당 공구의 공구 수명을 나타내는 실수형 속성입니다.
data://machine/toolArea/tools/toolEdge/toolLife/toolLifeCount	toolArea=1&tools=1&toolEdge=1&toolLifeCount=1	4.1.2.29 해당 공구의 공구 수명을 나타내는 실수형 속성입니다.
data://machine/toolArea/registerTools/toolEdge/toolLife/toolLifeCount	toolArea=1&registerTools=1&toolEdge=1&toolLifeCount=1	4.1.2.29 해당 공구의 공구 수명을 나타내는 실수형 속성입니다.
data://machine/channel/activetool/toolEdge/toolLife/toolLifeAlarm	channel=1	4.1.2.29 (SIEMENS 전용) 공구 사용에 대한 알람을 줄 수 있도록, 해당 공구의 한계 수명을 나타내는 실수형 속성입니다.
data://machine/toolArea/tools/toolEdge/toolLife/toolLifeAlarm	toolArea=1&tools=1&toolEdge=1	4.1.2.29 (SIEMENS 전용) 공구 사용에 대한 알람을 줄 수 있도록, 해당 공구의 한계 수명을 나타내는 실수형 속성입니다.
data://machine/toolArea/registerTools/toolEdge/toolLife/toolLifeAlarm	toolArea=1&registerTools=1&toolEdge=1	4.1.2.29 (SIEMENS 전용) 공구 사용에 대한 알람을 줄 수 있도록, 해당 공구의 한계 수명을 나타내는 실수형 속성입니다.
